[level]
tileset = inner_house.png
map =	XXXXXXXXXXXXXXXXXXXXXXXXX
	XXXXXXXXXXXXXXXXXXXXXXXXX
	XXXXXXXXXXXXXXXXXXXXXXXXX
	XXXXXXXXXXXXXXXXXXXXXXXXX
	XXXXXX/-----------\XXXXXX
	XXXXXX{___________}XXXXXX
	XXXXXXXXXXXXXXXXXXXXXXXXX
	XXXXXXXXXXXXXXXXXXXXXXXXX
	XXXXXXXXXXXXXXXXXXXXXXXXX
	XXXXXXXXXXXXXXXXXXXXXXXXX
	XXXXXXXXXXXXXXXXXXXXXXXXX
	XXXXXXXXXXXXXXXXXXXXXXXXX
	XXXXXXXXXXXXXXXXXXXXXXXXX
	XXXXXXXXXXXXXXXXXXXXXXXXX
	XXXXXXXXXXXXXXXXXXXXXXXXX
	XXXXXXXXXXXXXXXXXXXXXXXXX
	XXXXXX/-----------\XXXXXX
	XXXXXX(+++++++++++)XXXXXX
	XXXXXX(+++++++++++)XXXXXX
	XXXXXX(+++++++++++)XXXXXX
	XXXXXX(+++++++++++)XXXXXX
	XXXXXX(+++++++++++)XXXXXX
	XXXXXX{_____+_____}XXXXXX
	XXXXXXXXXXXX+XXXXXXXXXXXX
	XXXXXXXXXXXX+XXXXXXXXXXXX
	XXXXXXXXXXXXXXXXXXXXXXXXX
	XXXXXXXXXXXXXXXXXXXXXXXXX
	XXXXXXXXXXXXXXXXXXXXXXXXX
	XXXXXXXXXXXXXXXXXXXXXXXXX

[X]
name = black
tile = 0,0

[-]
name = top_wall
tile = 2,0

[_]
name = bottom_wall
tile = 2,2

[/]
name = top_left_wall
tile = 1,0

[\]
name = top_right_wall
tile = 3,0

[{]
name = bottom_left_wall
tile = 1,2

[}]
name = bottom_right_wall
tile = 3,2

[(]
name = left_wall
tile = 1,1

[)]
name = right_wall
tile = 3,1