[level]
tileset = inner_house.png
map =	XXXXXXXXXXXXXXXXXXXXXXXXX
	XXXXXXXXXXXXXXXXXXXXXXXXX
	XXXXXXXXXXXXXXXXXXXXXXXXX
	XXXXXXXXXXXXXXXXXXXXXXXXX
	XXXXXX+++++++++++++XXXXXX
	XXXXXX_____________XXXXXX
	XXXXXX---------------XXXX
	XXXXXXXXXXXXXXXXXXXX-XXXX
	XXXXXXXXXXXXXXXXXXXX-XXXX
	XXXXXXXXXXXXXXXXXXXX-XXXX
	XXXXXXXXXXXXXXXXXXXX-XXXX
	XXXXXXXXXXXXXXXXXXXX-XXXX
	XXXXXXXXXXXXXXXXXXXX-XXXX
	XXXXXXXXXXXXXXXXXXXX-XXXX
	XXXXXXXXXXXXXXXXXXXX-XXXX
	XXXXXXXXXXXXXXXXXXXX-XXXX
	XXXXXX+++++++++++++X-XXXX
	XXXXXX_____________X-XXXX
	XXXXXX-------------X-XXXX
	XXXXXX-------------X-XXXX
	XXXXXX-------------X-XXXX
	XXXXXX-------------X-XXXX
	XXXXXX---------------XXXX
	XXXXXX-------------XXXXXX
	XXXXXX-------------XXXXXX
	XXXXXXXXXXXXXXXXXXXXXXXXX
	XXXXXXXXXXXXXXXXXXXXXXXXX
	XXXXXXXXXXXXXXXXXXXXXXXXX
	XXXXXXXXXXXXXXXXXXXXXXXXX

[-]
name = floor
tile = 0,3

[+]
name = top_wall
tile = 6,0

[_]
name = bottom_wall
tile = 6,2