[level]
tileset = collision_layer
map =	XXXXXXXXXXXXXXXXXXXXXXXXX
	XXXXXXXXXXXXXXXXXXXXXXXXX
	XXXXXXXXXXXXXXXXXXXXXXXXX
	XXXXXXXXXXXXXXXXXXXXXXXXX
	XXXXXXXXXXXXXXXXXXXXXXXXX
	XXXXXXXXXXXXXXXXXXXXXXXXX
	XXXXXX---------------XXXX
	XXXXXXXXXXXXXXXXXXXX-XXXX
	XXXXXXXXXXXXXXXXXXXX-XXXX
	XXXXXXXXXXXXXXXXXXXX-XXXX
	XXXXXXXXXXXXXXXXXXXX-XXXX
	XXXXXXXXXXXXXXXXXXXX-XXXX
	XXXXXXXXXXXXXXXXXXXX-XXXX
	XXXXXXXXXXXXXXXXXXXX-XXXX
	XXXXXXXXXXXXXXXXXXXX-XXXX
	XXXXXXXXXXXXXXXXXXXX-XXXX
	XXXXXXXXXXXXXXXXXXXX-XXXX
	XXXXXXXXXXXXXXXXXXXX-XXXX
	XXXXXX-------------X-XXXX
	XXXXXX-------------X-XXXX
	XXXXXX-------------X-XXXX
	XXXXXX-------------X-XXXX
	XXXXXX---------------XXXX
	XXXXXX-------------XXXXXX
	XXXXXX-------------XXXXXX
	XXXXXXXXXXXX-XXXXXXXXXXXX
	XXXXXXXXXXXXXXXXXXXXXXXXX
	XXXXXXXXXXXXXXXXXXXXXXXXX
	XXXXXXXXXXXXXXXXXXXXXXXXX

[X]
collision = True