[level]
tileset = collision_layer
map =	-------------------------
	-------------------------
	-------------------------
	-XXXXXXXXXXXXXXXXXX------
	-XXXXXXXXXXXXXXXXXX------
	-----XXXXXXXX--XXXX------
	-XXXXXXXXXXXX--XXXX------
	-------------------------
	-------------------------
	-------------------------
	-------------------------
	-------------------------
	-------------------------
	-------------------------
	-------------XXXXXXXXX---
	-------------XXXXXXXXX---
	-------------XXXXXXXXX---
	-------------XXXX-XXXX---
	-------------------------
	-------------------------

[X]
collision = True