[level]
tileset = collision_layer
map =	XXXXXXXXXXXXXXXXXXXXXXXXX
	X------------------XXXXXX
	X------------------XXXXXX
	X------------------XXXXXX
	X------------------XXXXXX
	XXXXXXXXXXXXX--XXXXXXXXXX
	XXXXXXXXXXXXX--XXXXXXXXXX
	XXXXXXXXXXXXXXXXXXXXXXXXX
	XXXXXXXXXXXXXXXXXXXXXXXXX
	XXXXXXXXXXXXXXXXXXXXXXXXX
	XXXXXXXXXXXXXXXXXXXXXXXXX
	XXXXXXXXXXXXXXXXXXXXXXXXX
	XXXXXXXXXXXXXXXXXXXXXXXXX
	XXXXXXXXXXXXXXXXXXXXXXXXX
	XXXXXXXXXXXXXXXXXXXXXXXXX
	XXXXXXXXXXXXXXXXXXXXXXXXX
	XXXXXXXXXXXXXXXXXXXXXXXXX
	XXXXXXXXXXXXXXXXXXXXXXXXX
	XXXXXXXXXXXXXXXXXXXXXXXXX
	XXXXXXXXXXXXXXXXXXXXXXXXX

[X]
collision = True