tiles = {'g': [((9, 1), 7),
       ((8, 7), 1),
       ((8, 1), 1),
       ((7, 7), 1),
       ((7, 3), 3),
       ((7, 1), 1),
       ((6, 3), 5),
       ((6, 1), 1),
       ((5, 3), 3),
       ((5, 1), 1),
       ((4, 3), 7),
       ((4, 1), 1),
       ((3, 3), 3),
       ((3, 1), 1),
       ((2, 7), 3),
       ((2, 1), 1),
       ((1, 1), 7)],
 'q': [((10, 0), 9),
       ((9, 8), 1),
       ((9, 0), 1),
       ((8, 8), 1),
       ((8, 2), 5),
       ((8, 0), 1),
       ((7, 8), 1),
       ((7, 6), 1),
       ((7, 2), 1),
       ((7, 0), 1),
       ((6, 8), 1),
       ((6, 2), 1),
       ((6, 0), 1),
       ((5, 6), 4),
       ((5, 2), 1),
       ((5, 0), 1),
       ((4, 2), 1),
       ((4, 0), 1),
       ((3, 6), 4),
       ((3, 2), 1),
       ((3, 0), 1),
       ((2, 2), 5),
       ((2, 0), 1),
       ((1, 8), 2),
       ((1, 0), 1),
       ((0, 0), 9)]}
zones = {u'cont_exit': ((4, 9), (1, 1)),
 u'cont_msg': ((4, 7), (1, 1)),
 u'new_exit': ((2, 9), (1, 1)),
 u'new_msg1': ((6, 7), (1, 1)),
 u'new_msg2': ((9, 1), (1, 1)),
 u'new_msg3': ((1, 1), (1, 1)),
 u'new_msg4': ((1, 7), (1, 1)),
 u'start': ((4, 4), (1, 1))}
entities = []
